####################
#                  #
# ###### ##### # ###
######      ####   #
#      # ##    ### #
##### ##  ## #   # #
##    ## ##  ## ## #
#  # ### ## ##  ## #
## # #    #  # ##  #
##################S#