####################
#    #       ###   #
#### ### ### #### ##
#      # ###    # ##
# ###  # ### #### ##
# # #### ### # ## ##
# #      ### #    ##
# # ## # ### # ## ##
#    #   ###       S
####################
01234567890123456789