####################
#     #       ###  #
#### ### ### #######
#      # ###    # ##
# ###  # ### #### ##
# # #### ### # ## ##
# #      ### #    ##
# # ## # ### # ## ##
#    #   ###       S
####################